11100111111
10000000000
10000000001
00002200011
10002200011
10000000011
10000000011
10000000011
10000000011
11111001111
11111001111