11111111111111111111111111111111
13333333333333333333333333333331
13333333333333333333333333333331
13333333333333333333333333333331
13333333333333333333333333333331
13222222233322232223332333333231
13333233333200020002332333333231
13333233332000000000232333333231
13333233333200000002332333333231
13333233333320000023332333333231
13333233333332000233332333333231
13333233333333202333333233332331
13222222233333323333333322223331
13333333333333333333333333333331
13333333333333333333333333333331
13333333333333333333333333333331
11111111111111111111111111111111