0000000000000000000000000000000000000000
0111111111111111111111111111111111111110
0122222222222222221111222222222222222210
0121111112111111121111211111112111111210
0121111112111111121111211111112111111210
0131111112111111121111211111112111111310
0122222222222222222222222222222222222210
0121111112111211111111111121112111111210
0121111112111211111111111121112111111210
0122222222111222221111222221112222222210
0111111112111111121111211111112111111110
0111111112111111121111211111112111111110
0111111112111222222222222221112111111110
0111111112111211444444441121112111111110
0111111112111211000000001121112111111110
0000000002222211000000001122222000000000
0111111112111211000000001121112111111110
0111111112111211111111111121112111111110
0111111112111222222222222221112111111110
0111111112111211111111111121112111111110
0111111112111211111111111121112111111110
0122222222222222221111222222222222222210
0121111112111111121111211111112111111210
0121111112111111121111211111112111111210
0132221112222222222222222222222111222310
0111121112111211111111111121112111211110
0111121112111211111111111121112111211110
0122222222111222221111222221112222222210
0121111111111111121111211111111111111210
0121111111111111121111211111111111111210
0122222222222222222222222222222222222210
0111111111111111111111111111111111111110
0000000000000000000000000000000000000000